-02 -02 -02 -02 -02 -02 -02 -02 -02 -02 -02 -02 -02 -02 -02 -02 -02 -02 -02 -02 -02 -02 -02 -02 -02 -02 -02 -02
-02 -02 -02 -02 -02 -02 -02 -02 -02 -02 -02 -02 -02 -02 -02 -02 -02 -02 -02 -02 -02 -02 -02 -02 -02 -02 -02 -02
-02 -02 -02 -02 -02 -02 -02 -02 -02 -02 -02 -02 -02 -02 -02 -02 -02 -02 -02 -02 -02 -02 -02 -02 -02 -02 -02 -02
-01 -01 -01 -01 -01 -01 -01 -01 -01 -01 -01 -01 -01 -01 -01 -01 -01 -01 -01 -01 -01 -01 -01 -01 -01 -01 -01 -01
-01 000 001 002 003 004 005 006 007 008 009 010 011 -01 -01 012 013 014 015 016 017 018 019 020 021 022 023 -01
-01 024 -01 -01 -01 025 -01 -01 -01 -01 -01 -01 026 -01 -01 027 -01 -01 -01 -01 -01 -01 028 -01 -01 -01 029 -01
-01 030 -01 -01 -01 031 -01 -01 -01 -01 -01 -01 032 -01 -01 033 -01 -01 -01 -01 -01 -01 034 -01 -01 -01 035 -01
-01 036 037 038 039 040 041 042 043 044 045 046 047 048 049 050 051 052 053 054 055 056 057 058 059 060 061 -01
-01 062 -01 -01 -01 063 -01 -01 064 -01 -01 -01 -01 -01 -01 -01 -01 -01 -01 065 -01 -01 066 -01 -01 -01 067 -01
-01 068 069 070 071 072 073 074 075 -01 -01 -01 -01 -01 -01 -01 -01 -01 -01 076 077 078 079 080 081 082 083 -01
-01 -01 -01 -01 -01 084 -01 -01 085 086 087 088 089 -01 -01 090 091 092 093 094 -01 -01 095 -01 -01 -01 -01 -01
-02 -02 -02 -02 -01 096 -01 -01 -01 -01 -01 -01 097 -01 -01 098 -01 -01 -01 -01 -01 -01 099 -01 -02 -02 -02 -02
-02 -02 -02 -02 -01 100 -01 -01 -01 -01 -01 -01 101 -01 -01 102 -01 -01 -01 -01 -01 -01 103 -01 -02 -02 -02 -02
-02 -02 -02 -02 -01 104 -01 -01 -01 -01 -01 -01 105 -01 -01 106 -01 -01 -01 -01 -01 -01 107 -01 -02 -02 -02 -02
-02 -02 -02 -02 -01 108 -01 -01 109 110 111 112 113 114 115 116 117 118 119 120 -01 -01 121 -01 -02 -02 -02 -02
-01 -01 -01 -01 -01 122 -01 -01 123 -01 -01 -01 -01 -02 -02 -01 -01 -01 -01 124 -01 -01 125 -01 -01 -01 -01 -01
126 127 128 129 130 131 132 133 134 -01 -02 -02 -02 -02 -02 -02 -02 -02 -01 135 136 137 138 139 140 141 142 143
-01 -01 -01 -01 -01 144 -01 -01 145 -01 -01 -01 -01 -01 -01 -01 -01 -01 -01 146 -01 -01 147 -01 -01 -01 -01 -01
-02 -02 -02 -02 -01 148 -01 -01 149 150 151 152 153 154 155 156 157 158 159 160 -01 -01 161 -01 -02 -02 -02 -02
-02 -02 -02 -02 -01 162 -01 -01 -01 163 -01 -01 -01 -01 -01 -01 -01 -01 164 -01 -01 -01 165 -01 -02 -02 -02 -02
-02 -02 -02 -02 -01 166 -01 -01 -01 167 -01 -01 -01 -01 -01 -01 -01 -01 168 -01 -01 -01 169 -01 -02 -02 -02 -02
-02 -02 -02 -02 -01 170 171 172 173 174 175 176 177 178 179 180 181 182 183 184 185 186 187 -01 -02 -02 -02 -02
-01 -01 -01 -01 -01 188 -01 189 -01 -01 190 -01 -01 -01 -01 -01 -01 191 -01 -01 -01 -01 192 -01 -01 -01 -01 -01
-01 193 194 195 196 197 -01 198 -01 -01 199 -01 -01 -01 -01 -01 -01 200 201 202 203 -01 204 205 206 207 208 -01
-01 209 -01 -01 -01 210 -01 211 212 213 214 215 216 -01 -01 217 218 219 -01 -01 220 -01 221 -01 -01 -01 222 -01
-01 223 224 -01 -01 225 -01 -01 -01 -01 -01 -01 226 -01 -01 227 -01 228 -01 -01 229 -01 230 -01 -01 -01 231 -01
-01 -01 232 -01 -01 233 234 235 236 237 238 239 240 241 242 243 244 245 246 -01 247 248 249 -01 -01 250 251 -01
-01 252 253 -01 -01 254 -01 -01 -01 -01 -01 -01 255 -01 -01 -01 256 -01 257 258 259 -01 260 -01 -01 261 -01 -01
-01 262 -01 -01 -01 263 -01 -01 -01 264 265 266 267 -01 -01 -01 268 -01 -01 -01 -01 -01 269 -01 -01 270 271 -01
-01 272 -01 -01 -01 273 -01 -01 -01 274 -01 -01 275 -01 -01 -01 276 -01 -01 -01 -01 -01 277 -01 -01 -01 278 -01
-01 279 280 281 282 283 284 285 286 287 288 289 290 291 292 293 294 295 296 297 298 299 300 301 302 303 304 -01
-01 -01 -01 -01 -01 -01 -01 -01 -01 -01 -01 -01 -01 -01 -01 -01 -01 -01 -01 -01 -01 -01 -01 -01 -01 -01 -01 -01
-02 -02 -02 -02 -02 -02 -02 -02 -02 -02 -02 -02 -02 -02 -02 -02 -02 -02 -02 -02 -02 -02 -02 -02 -02 -02 -02 -02
-02 -02 -02 -02 -02 -02 -02 -02 -02 -02 -02 -02 -02 -02 -02 -02 -02 -02 -02 -02 -02 -02 -02 -02 -02 -02 -02 -02